1111111111
1000000001
1011000001
1011000001
1000000001
1000000001
1000001101
1000001101
1000000001
1111111111
